"aa" = (/turf/simulated/floor/tiled/dark,/area/deepmaint)
"ab" = (/turf/simulated/floor/tiled/dark/panels,/area/deepmaint)
"ac" = (/obj/effect/decal/cleanable/blood/oil,/turf/simulated/floor/tiled/dark/panels,/area/deepmaint)
"ad" = (/obj/random/cluster/roaches/low_chance,/turf/simulated/floor/tiled/dark/panels,/area/deepmaint)
"ae" = (/obj/machinery/light/small,/turf/simulated/floor/tiled/dark/panels,/area/deepmaint)
"af" = (/turf/simulated/floor/tiled/dark/gray_platform,/area/deepmaint)
"ag" = (/turf/simulated/wall/r_wall,/area/deepmaint)
"ah" = (/obj/effect/decal/cleanable/blood/oil,/turf/simulated/floor/tiled/dark/gray_platform,/area/deepmaint)
"ai" = (/obj/machinery/light/small{dir = 4; pixel_y = 0},/turf/simulated/floor/tiled/dark,/area/deepmaint)
"aj" = (/turf/simulated/wall,/area/deepmaint)
"ak" = (/turf/simulated/shuttle/wall/escpod{icon_state = "escpodwall19"; tag = "icon-escpodwall19"},/area/deepmaint)
"al" = (/turf/simulated/shuttle/wall/escpod{icon_state = "escpodwall20"; tag = "icon-escpodwall20"},/area/deepmaint)
"am" = (/turf/simulated/shuttle/wall/escpod{icon_state = "escpodwall21"; tag = "icon-escpodwall21"},/area/deepmaint)
"an" = (/turf/simulated/shuttle/wall/escpod{icon_state = "escpodwall22"; tag = "icon-escpodwall22"},/area/deepmaint)
"ao" = (/turf/simulated/shuttle/wall/escpod{icon_state = "escpodwall23"; opacity = 0; tag = "icon-escpodwall23"},/area/deepmaint)
"ap" = (/turf/simulated/shuttle/wall/escpod{icon_state = "escpodwall24"; opacity = 0; tag = "icon-escpodwall24"},/area/deepmaint)
"aq" = (/turf/simulated/shuttle/wall/escpod{icon_state = "escpodwall25"; tag = "icon-escpodwall25"},/area/deepmaint)
"ar" = (/turf/simulated/shuttle/wall/escpod{icon_state = "escpodwall26"; tag = "icon-escpodwall26"},/area/deepmaint)
"as" = (/obj/structure/shuttle_part/escpod{icon_state = "escpodwall27"; tag = "icon-escpodwall27"},/turf/simulated/floor/tiled/dark/techfloor_grid,/area/deepmaint)
"at" = (/obj/structure/shuttle_part/escpod{icon_state = "escpodwall28"; tag = "icon-escpodwall28"},/turf/simulated/floor/tiled/dark/techfloor_grid,/area/deepmaint)
"au" = (/turf/simulated/floor/tiled/dark/techfloor_grid,/area/deepmaint)
"av" = (/obj/machinery/door/blast/regular,/turf/simulated/floor/tiled/dark/gray_platform,/area/deepmaint)
"aw" = (/turf/simulated/mineral,/area/deepmaint)
"ax" = (/turf/simulated/floor/tiled/dark/cargo,/area/deepmaint)
"ay" = (/turf/simulated/shuttle/wall/escpod{icon_state = "escpodwall16"; tag = "icon-escpodwall16"},/area/deepmaint)
"az" = (/obj/structure/bed/chair/shuttle,/turf/simulated/shuttle/floor/mining,/area/deepmaint)
"aB" = (/obj/structure/bed/chair/shuttle,/obj/machinery/light{dir = 1},/turf/simulated/shuttle/floor/mining,/area/deepmaint)
"aC" = (/obj/structure/bed/chair/shuttle,/obj/random/junk,/turf/simulated/shuttle/floor/mining,/area/deepmaint)
"aD" = (/obj/structure/table/rack,/obj/random/pack/gun_loot,/obj/random/pack/gun_loot,/obj/random/pack/gun_loot,/obj/random/pack/gun_loot,/obj/random/pack/gun_loot/low_chance,/obj/random/pack/gun_loot/low_chance,/turf/simulated/shuttle/floor/mining,/area/deepmaint)
"aF" = (/turf/simulated/shuttle/wall/escpod{icon_state = "escpodwall17"; tag = "icon-escpodwall17"},/area/deepmaint)
"aG" = (/obj/structure/shuttle_part/escpod{icon_state = "escpodwall18"; tag = "icon-escpodwall18"},/turf/simulated/floor/tiled/dark/techfloor,/area/deepmaint)
"aH" = (/turf/simulated/floor/tiled/dark/techfloor,/area/deepmaint)
"aI" = (/obj/random/junk,/obj/random/junk,/turf/simulated/floor/plating/under,/area/deepmaint)
"aJ" = (/obj/structure/girder,/obj/structure/barricade,/turf/simulated/shuttle/floor/mining,/area/deepmaint)
"aK" = (/obj/random/junk,/obj/random/junk,/turf/simulated/shuttle/floor/mining,/area/deepmaint)
"aL" = (/obj/random/junk,/turf/simulated/shuttle/floor/mining,/area/deepmaint)
"aM" = (/turf/simulated/shuttle/floor/mining,/area/deepmaint)
"aN" = (/obj/structure/closet/walllocker/emerglocker/north,/obj/structure/closet/walllocker/emerglocker/north{dir = 1; pixel_y = -32},/obj/item/remains/human,/obj/random/pack/cloth,/obj/random/pack/cloth,/obj/random/gun_normal,/turf/simulated/shuttle/floor/mining,/area/deepmaint)
"aO" = (/turf/simulated/shuttle/wall/escpod{icon_state = "escpodwall14"; tag = "icon-escpodwall14"},/area/deepmaint)
"aP" = (/obj/structure/shuttle_part/escpod{icon_state = "escpodwall15"; tag = "icon-escpodwall15"},/turf/simulated/floor/tiled/dark/techfloor,/area/deepmaint)
"aQ" = (/obj/random/scrap/sparse_even,/turf/simulated/floor/plating/under,/area/deepmaint)
"aR" = (/turf/simulated/shuttle/wall/escpod{icon_state = "escpodwall11"; tag = "icon-escpodwall11"},/area/deepmaint)
"aS" = (/obj/item/device/radio/intercom{dir = 4; pixel_x = -22},/obj/structure/bed/chair/shuttle{dir = 1; icon_state = "shuttle_chair"; tag = "icon-shuttle_chair (NORTH)"},/turf/simulated/shuttle/floor/mining,/area/deepmaint)
"aT" = (/obj/structure/bed/chair/shuttle{dir = 1; icon_state = "shuttle_chair"; tag = "icon-shuttle_chair (NORTH)"},/obj/random/junk,/turf/simulated/shuttle/floor/mining,/area/deepmaint)
"aU" = (/obj/structure/bed/chair/shuttle{dir = 1; icon_state = "shuttle_chair"; tag = "icon-shuttle_chair (NORTH)"},/obj/machinery/light,/obj/random/junk,/turf/simulated/shuttle/floor/mining,/area/deepmaint)
"aV" = (/obj/structure/bed/chair/shuttle{dir = 1; icon_state = "shuttle_chair"; tag = "icon-shuttle_chair (NORTH)"},/turf/simulated/shuttle/floor/mining,/area/deepmaint)
"aW" = (/obj/structure/table/rack,/turf/simulated/shuttle/floor/mining,/area/deepmaint)
"aX" = (/obj/structure/table/rack,/obj/random/firstaid,/obj/random/firstaid,/turf/simulated/shuttle/floor/mining,/area/deepmaint)
"aY" = (/turf/simulated/shuttle/wall/escpod{icon_state = "escpodwall12"; tag = "icon-escpodwall12"},/area/deepmaint)
"aZ" = (/obj/structure/shuttle_part/escpod{icon_state = "escpodwall13"; tag = "icon-escpodwall13"},/turf/simulated/floor/tiled/dark/techfloor,/area/deepmaint)
"ba" = (/turf/simulated/shuttle/wall/escpod,/area/deepmaint)
"bb" = (/turf/simulated/shuttle/wall/escpod{icon_state = "escpodwall2"; tag = "icon-escpodwall2"},/area/deepmaint)
"bc" = (/turf/simulated/shuttle/wall/escpod{icon_state = "escpodwall3"; tag = "icon-escpodwall3"},/area/deepmaint)
"bd" = (/turf/simulated/shuttle/wall/escpod{icon_state = "escpodwall4"; tag = "icon-escpodwall4"},/area/deepmaint)
"be" = (/turf/simulated/shuttle/wall/escpod{icon_state = "escpodwall5"; opacity = 0; tag = "icon-escpodwall5"},/area/deepmaint)
"bf" = (/turf/simulated/shuttle/wall/escpod{icon_state = "escpodwall6"; opacity = 0; tag = "icon-escpodwall6"},/area/deepmaint)
"bg" = (/turf/simulated/shuttle/wall/escpod{icon_state = "escpodwall7"; tag = "icon-escpodwall7"},/area/deepmaint)
"bh" = (/turf/simulated/shuttle/wall/escpod{icon_state = "escpodwall8"; tag = "icon-escpodwall8"},/area/deepmaint)
"bi" = (/obj/structure/shuttle_part/escpod{icon_state = "escpodwall9"; tag = "icon-escpodwall9"},/turf/simulated/floor/tiled/dark/techfloor_grid,/area/deepmaint)
"bj" = (/obj/structure/shuttle_part/escpod{icon_state = "escpodwall10"; tag = "icon-escpodwall10"},/turf/simulated/floor/tiled/dark/techfloor_grid,/area/deepmaint)
"bk" = (/obj/random/cluster/roaches/low_chance,/turf/simulated/floor/tiled/dark/gray_platform,/area/deepmaint)
"bl" = (/turf/simulated/floor/tiled/dark/gray_perforated,/area/deepmaint)
"bm" = (/obj/item/weapon/stool,/turf/simulated/floor/tiled/dark/gray_perforated,/area/deepmaint)
"bn" = (/obj/structure/table/standard,/obj/random/pack/tech_loot,/obj/random/pack/tech_loot,/obj/random/pack/tech_loot/low_chance,/obj/random/pack/tech_loot/low_chance,/turf/simulated/floor/tiled/dark/gray_perforated,/area/deepmaint)
"bo" = (/obj/structure/reagent_dispensers/fueltank,/turf/simulated/floor/tiled/dark/gray_perforated,/area/deepmaint)
"bp" = (/obj/machinery/light/small{dir = 1},/turf/simulated/floor/tiled/dark/gray_platform,/area/deepmaint)
"bq" = (/obj/structure/computerframe{anchored = 1; dir = 8; icon_state = "0"; tag = "icon-0 (WEST)"},/turf/simulated/floor/tiled/dark/gray_perforated,/area/deepmaint)
"br" = (/obj/machinery/door/firedoor,/obj/effect/window_lwall_spawn/smartspawn,/turf/simulated/floor/plating,/area/deepmaint)
"bs" = (/obj/machinery/chemical_dispenser/industrial,/turf/simulated/floor/tiled/dark/gray_perforated,/area/deepmaint)
"bt" = (/obj/machinery/autolathe/loaded,/turf/simulated/floor/tiled/dark/gray_perforated,/area/deepmaint)
"bu" = (/obj/structure/table/standard,/obj/random/material,/obj/random/material,/obj/random/material,/obj/random/material,/obj/random/material,/obj/random/material,/turf/simulated/floor/tiled/dark/gray_perforated,/area/deepmaint)
"bv" = (/obj/structure/table/standard,/obj/random/material_rare,/obj/random/material_rare,/obj/random/material_rare,/obj/random/material_rare,/obj/random/material_rare,/turf/simulated/floor/tiled/dark/gray_perforated,/area/deepmaint)
"bw" = (/obj/structure/table/standard,/obj/random/pack/tech_loot,/obj/random/pack/tech_loot,/obj/random/pack/tech_loot,/obj/random/pack/tech_loot/low_chance,/obj/random/pack/tech_loot/low_chance,/turf/simulated/floor/tiled/dark/gray_perforated,/area/deepmaint)
"bx" = (/obj/structure/table/standard,/obj/item/weapon/storage/toolbox/mechanical{pixel_x = -2; pixel_y = -1},/obj/item/clothing/head/welding,/turf/simulated/floor/tiled/dark/gray_perforated,/area/deepmaint)
"by" = (/obj/machinery/door/airlock/maintenance_common{name = "Service Maintenance"; req_access = list(12)},/turf/simulated/floor/tiled/dark/cargo,/area/deepmaint)
"bz" = (/obj/structure/bed/chair{dir = 4},/obj/item/remains/human,/obj/random/pack/cloth,/obj/random/pack/cloth,/turf/simulated/floor/tiled/dark/gray_perforated,/area/deepmaint)
"bA" = (/obj/effect/window_lwall_spawn/smartspawn,/turf/simulated/floor/plating,/area/deepmaint)
"bB" = (/obj/effect/decal/cleanable/blood/oil,/turf/simulated/floor/tiled/dark/cargo,/area/deepmaint)
"bD" = (/obj/structure/bed/chair/shuttle,/obj/effect/decal/cleanable/blood,/turf/simulated/shuttle/floor/mining,/area/deepmaint)
"bE" = (/obj/structure/bed/chair/shuttle,/obj/machinery/light{dir = 1},/obj/effect/decal/cleanable/blood,/turf/simulated/shuttle/floor/mining,/area/deepmaint)
"bF" = (/obj/structure/bed/chair/shuttle,/obj/effect/decal/cleanable/blood,/obj/item/remains/human,/obj/random/pack/cloth,/obj/random/pack/cloth,/obj/random/pack/tech_loot/low_chance,/obj/random/pack/gun_loot,/turf/simulated/shuttle/floor/mining,/area/deepmaint)
"bG" = (/obj/effect/decal/cleanable/blood/drip,/obj/effect/decal/cleanable/blood/oil,/turf/simulated/shuttle/floor/mining,/area/deepmaint)
"bH" = (/obj/effect/decal/cleanable/blood,/obj/effect/decal/cleanable/blood/drip,/obj/item/remains/human,/obj/random/pack/cloth,/obj/random/pack/cloth,/obj/random/pack/tech_loot/low_chance,/obj/random/pack/gun_loot,/turf/simulated/shuttle/floor/mining,/area/deepmaint)
"bI" = (/obj/effect/decal/cleanable/blood,/turf/simulated/floor/tiled/dark/cargo,/area/deepmaint)
"bJ" = (/obj/effect/decal/cleanable/blood,/obj/effect/decal/cleanable/blood/drip,/turf/simulated/shuttle/floor/mining,/area/deepmaint)
"bL" = (/obj/effect/decal/cleanable/blood,/obj/effect/decal/cleanable/blood,/obj/effect/decal/cleanable/blood/drip,/obj/effect/decal/cleanable/blood/drip,/turf/simulated/shuttle/floor/mining,/area/deepmaint)
"bM" = (/obj/effect/decal/cleanable/blood,/obj/item/remains/human,/obj/random/pack/cloth,/obj/random/pack/cloth,/obj/random/pack/tech_loot/low_chance,/obj/random/pack/gun_loot,/turf/simulated/shuttle/floor/mining,/area/deepmaint)
"bN" = (/obj/effect/decal/cleanable/blood,/obj/effect/decal/cleanable/blood/drip,/obj/effect/decal/cleanable/blood,/obj/effect/decal/cleanable/blood,/obj/effect/decal/cleanable/blood,/turf/simulated/shuttle/floor/mining,/area/deepmaint)
"bO" = (/obj/effect/decal/cleanable/blood,/obj/effect/decal/cleanable/blood,/turf/simulated/shuttle/floor/mining,/area/deepmaint)
"bP" = (/obj/structure/closet/walllocker/emerglocker/north,/obj/structure/closet/walllocker/emerglocker/north{dir = 1; pixel_y = -32},/obj/effect/decal/cleanable/blood,/obj/effect/decal/cleanable/blood/drip,/obj/item/remains/human,/obj/random/pack/cloth,/obj/random/pack/cloth,/obj/random/pack/tech_loot/low_chance,/obj/random/pack/gun_loot,/turf/simulated/shuttle/floor/mining,/area/deepmaint)
"bQ" = (/obj/item/remains/human,/obj/random/pack/cloth,/obj/random/pack/cloth,/obj/random/pack/tech_loot/low_chance,/obj/random/pack/gun_loot,/turf/simulated/floor/tiled/dark/cargo,/area/deepmaint)
"bR" = (/obj/item/device/radio/intercom{dir = 4; pixel_x = -22},/obj/structure/bed/chair/shuttle{dir = 1; icon_state = "shuttle_chair"; tag = "icon-shuttle_chair (NORTH)"},/obj/effect/decal/cleanable/blood,/turf/simulated/shuttle/floor/mining,/area/deepmaint)
"bS" = (/obj/effect/decal/cleanable/blood,/turf/simulated/shuttle/floor/mining,/area/deepmaint)
"bT" = (/obj/structure/bed/chair/shuttle{dir = 1; icon_state = "shuttle_chair"; tag = "icon-shuttle_chair (NORTH)"},/obj/machinery/light,/obj/effect/decal/cleanable/blood/drip,/obj/effect/decal/cleanable/blood,/turf/simulated/shuttle/floor/mining,/area/deepmaint)
"bU" = (/obj/effect/decal/cleanable/blood,/obj/effect/decal/cleanable/blood/drip,/obj/effect/decal/cleanable/blood/drip,/turf/simulated/shuttle/floor/mining,/area/deepmaint)
"bV" = (/obj/effect/decal/cleanable/blood,/obj/effect/decal/cleanable/blood/drip,/obj/effect/decal/cleanable/blood,/turf/simulated/shuttle/floor/mining,/area/deepmaint)
"bW" = (/obj/random/junk,/turf/simulated/floor/tiled/dark/panels,/area/deepmaint)
"bX" = (/obj/item/weapon/stool,/turf/simulated/floor/tiled/dark/panels,/area/deepmaint)
"bY" = (/obj/machinery/light/small{dir = 1},/turf/simulated/floor/tiled/dark/panels,/area/deepmaint)
"bZ" = (/obj/machinery/door/blast/regular,/turf/simulated/floor/tiled/dark/techfloor_grid,/area/deepmaint)

(1,1,1) = {"
aaaaaaaaaaaaaaaaaaaaaaaaaaaaaaaaaaaaaaaaaa
aaabababababababababababacabadabababaeabaa
aaabafagagafafafafafafahahabagagagagagabaa
aiajafakalamanaoapaqarasataubZawawawagabaa
aaaxaxayazaLaBaCaDaDaMaFaGaHavaIawawagabaa
aaaxaxaJaKaKaLaKaLaMaNaOaPaHavaQaQawagabaa
aaaxaxaRaSaTaUaVaWaXaMaYaZaHavaQaQaQagabaa
aaajafbabbbcbdbebfbgbhbibjaubZaIawaQagabaa
aaabafafahafafafafafafahahabagagagagagabaa
aaabbkblblblbmbmbmbnboblahabajbpblbqbrabaa
aaabafblbsbtbubvbwbwbxblafabbyafbzbqbAabaa
aaabafblblblbmbmbmbnboblafabajafblbqbrabaa
aaabafafafafafafafafafafahabagagagagagabaa
aaajahakalamanaoapaqarasataubZaIawawagabaa
aaaxbBaybMbDbEbFbGbHaMaFaGaHavaQawawagabaa
aaaxbIbJbSbLbMbNbObJbPaOaPaHavaQaQaQagabaa
aaaxbQaRbRbSbTbUbVbHaMaYaZaHavaQaQawagabaa
aiajafbabbbcbdbebfbgbhbibjaubZaIawawagabaa
aaabafagagafafafafafafafahabagagagagagabaa
aaababbWbXababababababababababadababbYabaa
aaaaaaaaaaaaaaaaaaaaaaaaaaaaaaaaaaaaaaaaaa
"}
